{
  "levels": [
    {
      "level": 1,
      "width": 18,
			"height": 18,
			"startX": 1,
			"startY": 1,
      "walls": [
					4, 4, 3, 2, 2, 6, 1, 4, 3, 5, 4, 2, 2, 5, 6, 4, 3, 2,
					1, 0, 5, 0, 0, 0, 1, 0, 0, 0, 3, 1, 3, 0, 3, 0, 0, 0,
					3, 0, 1, 1, 5, 0, 0, 0, 4, 0, 3, 0, 0, 0, 5, 0, 0, 3,
					6, 0, 0, 0, 1, 0, 3, 3, 5, 0, 1, 0, 4, 3, 2, 0, 6, 3,
					1, 0, 4, 0, 0, 0, 6, 0, 0, 0, 5, 0, 6, 0, 0, 0, 1, 1,
					3, 5, 4, 4, 2, 1, 6, 6, 0, 3, 1, 0, 5, 2, 0, 6, 4, 1,
					5, 0, 0, 0, 0, 0, 5, 2, 0, 3, 6, 0, 0, 0, 0, 0, 0, 2,
					1, 0, 2, 3, 5, 0, 0, 0, 0, 0, 1, 6, 5, 4, 0, 2, 1, 2,
					1, 0, 2, 0, 4, 0, 2, 3, 1, 2, 3, 0, 1, 0, 0, 6, 5, 1,
					2, 0, 0, 0, 1, 0, 0, 0, 0, 0, 5, 0, 0, 0, 1, 0, 0, 1,
					1, 0, 3, 2, 4, 3, 2, 0, 1, 0, 4, 0, 0, 0, 0, 0, 2, 2,
					3, 0, 6, 0, 0, 0, 3, 0, 4, 0, 4, 0, 4, 1, 1, 0, 5, 1,
					5, 0, 4, 1, 2, 0, 5, 0, 2, 0, 1, 0, 6, 2, 6, 0, 5, 1,
					6, 0, 0, 0, 1, 0, 2, 0, 2, 0, 0, 0, 0, 3, 0, 0, 1, 1,
					3, 6, 4, 0, 2, 0, 2, 0, 3, 0, 4, 5, 0, 0, 1, 6, 2, 1,
					1, 0, 0, 0, 1, 0, 0, 0, 0, 0, 0, 1, 2, 3, 5, 0, 0, 1,
					3, 0, 4, 0, 1, 1, 5, 6, 0, 1, 0, 0, 0, 0, 0, 0, 0, 1,
					1, 1, 1, 1, 1, 1, 1, 1, 1, 2, 4, 5, 3, 2, 3, 5, 1, 6
      ],
			"floor": [
					0, 0, 0, 0, 0, 0, 0, 0, 0, 0, 0, 0, 0, 0, 0, 0, 0, 0, 
					0, 0, 0, 1, 0, 3, 0, 0, 0, 5, 0, 0, 4, 0, 0, 3, 0, 0, 
					0, 1, 0, 0, 2, 0, 2, 0, 5, 0, 4, 0, 0, 2, 0, 0, 1, 0, 
					0, 0, 3, 0, 3, 0, 2, 3, 0, 0, 0, 1, 0, 0, 1, 0, 4, 0, 
					0, 0, 0, 1, 0, 3, 0, 0, 0, 5, 0, 0, 4, 0, 0, 3, 0, 0, 
					0, 1, 0, 0, 2, 0, 2, 0, 5, 0, 4, 0, 0, 2, 0, 0, 1, 0, 
					0, 0, 3, 0, 3, 0, 2, 3, 0, 0, 0, 1, 0, 0, 1, 0, 4, 0, 
					0, 0, 0, 1, 0, 3, 0, 0, 0, 5, 0, 0, 4, 0, 0, 3, 0, 0, 
					0, 1, 0, 0, 2, 0, 2, 0, 5, 0, 4, 0, 0, 2, 0, 0, 1, 0, 
					0, 0, 3, 0, 3, 0, 2, 3, 0, 0, 0, 1, 0, 0, 1, 0, 4, 0, 
					0, 0, 0, 1, 0, 3, 0, 0, 0, 5, 0, 0, 4, 0, 0, 3, 0, 0, 
					0, 1, 0, 0, 2, 0, 2, 0, 5, 0, 4, 0, 0, 2, 0, 0, 1, 0, 
					0, 0, 3, 0, 3, 0, 2, 3, 0, 0, 0, 1, 0, 0, 1, 0, 4, 0, 
					0, 0, 0, 1, 0, 3, 0, 0, 0, 5, 0, 0, 4, 0, 0, 3, 0, 0, 
					0, 0, 0, 1, 0, 3, 0, 0, 0, 5, 0, 0, 4, 0, 0, 3, 0, 0, 
					0, 1, 0, 0, 2, 0, 2, 0, 5, 0, 4, 0, 0, 2, 0, 0, 1, 0, 
					0, 0, 3, 0, 3, 0, 2, 3, 0, 0, 0, 1, 0, 0, 1, 0, 4, 0, 
					0, 0, 0, 0, 0, 0, 0, 0, 0, 0, 0, 0, 0, 0, 0, 0, 0, 0

			],
			"enemies": 5,
			"chasers": 0,
			"exitX": 8,
			"exitY": 16
    },
		{
      "level": 2,
      "width": 18,
			"height": 18,
			"startX": 2,
			"startY": 2,
      "walls": [
					1, 1, 1, 1, 1, 1, 1, 1, 1, 1, 1, 1, 1, 1, 1, 1, 1, 1,
					1, 0, 0, 0, 1, 0, 0, 0, 1, 0, 0, 0, 0, 0, 0, 0, 0, 1,
					1, 0, 0, 0, 0, 0, 0, 0, 1, 0, 0, 0, 0, 0, 0, 0, 0, 1,
					1, 0, 0, 0, 1, 0, 0, 0, 1, 0, 0, 1, 0, 1, 1, 0, 0, 1,
					1, 1, 1, 1, 1, 0, 0, 0, 1, 0, 0, 0, 1, 0, 1, 0, 0, 1,
					1, 0, 0, 0, 1, 0, 0, 0, 1, 0, 0, 0, 1, 0, 0, 0, 0, 1,
					1, 0, 0, 0, 0, 0, 0, 0, 1, 1, 1, 1, 0, 0, 0, 0, 0, 1,
					1, 0, 0, 0, 1, 0, 0, 0, 1, 0, 0, 0, 0, 0, 0, 0, 0, 1,
					1, 0, 0, 0, 1, 0, 0, 0, 1, 0, 1, 1, 1, 1, 0, 0, 1, 1,
					1, 0, 0, 0, 1, 1, 1, 1, 1, 0, 0, 1, 0, 0, 0, 0, 0, 1,
					1, 0, 0, 0, 0, 0, 0, 0, 1, 1, 0, 1, 0, 0, 0, 0, 0, 1,
					1, 0, 0, 0, 0, 0, 0, 0, 1, 0, 0, 0, 1, 1, 0, 1, 1, 1,
					1, 0, 0, 0, 0, 0, 0, 0, 1, 0, 0, 0, 0, 1, 0, 1, 0, 1,
					1, 1, 1, 1, 1, 0, 1, 0, 1, 1, 0, 0, 0, 1, 0, 1, 0, 1,
					1, 0, 0, 0, 1, 0, 1, 0, 0, 0, 0, 0, 0, 1, 0, 1, 0, 1,
					1, 0, 0, 0, 1, 0, 1, 0, 0, 0, 0, 0, 0, 1, 0, 0, 0, 1,
					1, 0, 0, 0, 0, 0, 1, 0, 0, 0, 0, 0, 0, 1, 0, 0, 0, 1,
					1, 1, 1, 1, 1, 1, 1, 1, 1, 1, 1, 1, 1, 1, 1, 1, 1, 1
      ],
			"floor": [
					0, 0, 0, 0, 0, 0, 0, 0, 0, 0, 0, 0, 0, 0, 0, 0, 0, 0, 
					0, 0, 0, 0, 0, 0, 0, 0, 0, 0, 0, 0, 0, 0, 0, 0, 0, 0, 
					0, 0, 0, 0, 0, 0, 0, 0, 0, 0, 0, 0, 0, 0, 0, 0, 0, 0, 
					0, 0, 0, 0, 0, 0, 0, 0, 0, 0, 0, 0, 0, 0, 0, 0, 0, 0, 
					0, 0, 0, 0, 0, 0, 0, 0, 0, 0, 0, 0, 0, 0, 0, 0, 0, 0, 
					0, 0, 0, 0, 0, 0, 0, 0, 0, 0, 0, 0, 0, 0, 0, 0, 0, 0, 
					0, 0, 0, 0, 0, 0, 0, 0, 0, 0, 0, 0, 0, 0, 0, 0, 0, 0, 
					0, 0, 0, 0, 0, 0, 0, 0, 0, 0, 0, 0, 0, 0, 0, 0, 0, 0, 
					0, 0, 0, 0, 0, 0, 0, 0, 0, 0, 0, 0, 0, 0, 0, 0, 0, 0, 
					0, 0, 0, 0, 0, 0, 0, 0, 0, 0, 0, 0, 0, 0, 0, 0, 0, 0, 
					0, 0, 0, 0, 0, 0, 0, 0, 0, 0, 0, 0, 0, 0, 0, 0, 0, 0, 
					0, 0, 0, 0, 0, 0, 0, 0, 0, 0, 0, 0, 0, 0, 0, 0, 0, 0, 
					0, 0, 0, 0, 0, 0, 0, 0, 0, 0, 0, 0, 0, 0, 0, 0, 0, 0, 
					0, 0, 0, 0, 0, 0, 0, 0, 0, 0, 0, 0, 0, 0, 0, 0, 0, 0, 
					0, 0, 0, 0, 0, 0, 0, 0, 0, 0, 0, 0, 0, 0, 0, 0, 0, 0, 
					0, 0, 0, 0, 0, 0, 0, 0, 0, 0, 0, 0, 0, 0, 0, 0, 0, 0, 
					0, 0, 0, 0, 0, 0, 0, 0, 0, 0, 0, 0, 0, 0, 0, 0, 0, 0, 
					0, 0, 0, 0, 0, 0, 0, 0, 0, 0, 0, 0, 0, 0, 0, 0, 0, 0
			],
			"enemies": 0,
			"chasers": 0,
			"exitX": -1,
			"exitY": -1
    },
		{
      "level": 3,
      "width": 10,
			"height": 10,
			"startX": 2,
			"startY": 2,
      "walls": [
					1,1,1,1,1,1,1,1,1,1,
					1,0,0,0,0,0,0,0,0,1,
					1,0,0,0,0,0,0,0,0,1,
					1,0,0,1,0,0,1,0,0,1,
					1,0,0,0,0,0,0,0,0,1,
					1,0,0,0,0,0,0,0,0,1,
					1,0,0,1,0,0,1,0,0,1,
					1,0,0,0,0,0,0,0,0,1,
					1,0,0,0,0,0,0,0,0,1,
					1,1,1,1,1,1,1,1,1,1
      ],
			"floor": [
					1,1,1,1,1,1,1,1,1,1,
					1,0,0,0,0,0,0,0,0,1,
					1,0,0,0,0,0,0,0,0,1,
					1,0,0,0,0,0,0,0,0,1,
					1,0,0,0,0,0,0,0,0,1,
					1,0,0,0,0,0,0,0,0,1,
					1,0,0,0,0,0,0,0,0,1,
					1,0,0,0,0,0,0,0,0,1,
					1,0,0,0,0,0,0,0,0,1,
					1,1,1,1,1,1,1,1,1,1
			],
			"enemies": 0,
			"chasers": 0,
			"exitX": -1,
			"exitY": -1
    }
  ]
}